AAAAAAAAAAAAAAAAAAAAAAAAAAAAAAAAAAG
AAAAAAAAAAAAAAAAAAAAAAAAAAAAAAAAAAG
AAAAAAAAAAAAAAAAAAAAAAAAAAAAAAAAAAG
AAAAAAAAAAAAAAAAAAAAAAAAAAAAAAAAAAG
AAAAAAAAAAAAAAAAAAAAAAAAAAAAAAAAAAG
AAAAAAAAAAAAAAAAAAAAAAAAAAAAAAAAAAG
AAAAAAAAAAAAAAAAAAAAAAAAAAAAAAAAAAG
AAAAAAAAAAAAAAAAAAAAAAAAAAAAAAAAAAG
AAAAAAAAAAAAAAAAAAAAAAAAAAAAAAAAAAG
AAAAAAQAAAAAAAAAAAAAAAAAAAAAAAAAAAG
AAAAAAAAAAAAAAAAAAAAAAAAAAAAAAAAAAG
AAAAFFFFFAAAAAFFFAAAAAAAAAAAAAAAAAG
SAAFFFFFFAAAFFFFFAAAAAAFAAAAEAAAAFG
FFFFFFFFFWWWFFFFFWWFWWFFFFFFFFFFFFG
FFFFFFFFFWWWFFFFFWWFWWFFFFFFFFFFFFG