AAAAAAAAAAAAAAAAAAAAAAAAAAAAAAAAAAAAAAAAAAAAAAAAAAA
AAAAAAAAAAAAAAAAAAAAAAAAAAAAAAAAAAAAAAAAAAAAAAAAAAA
AAAAAAAAAAAAAAAAAAAAAAAAAAAAAAAAAAAAAAAAAAAAAAAAAAA
AAAAAAAAAAAAAAAAAAAAAAAAAAAAAAAAAAAAAAAAAAAAAAAAAAA
AAAAAAAAAAAAAAAAAAAAAAAAAAAAAAAAAAAAAAAAAAAAAAAAAAA
AAAAAAAAAAAAAAAAAAAAAAAAAAAAAAAAAAAAAAAAAAAAAAAAAAA
AAAAAAAAAAAAAAAAAAAAAAAAAAAAAAAAAAAAAAAAAAAAAAAAAAA
AAAAAAAAAAAAAAAAAAAAAAAAAAAAAAAAAAAAAAAAAAAAAAAAAAA
AAAAAAAAAAAAAAAAAAAAAAAAAAAAAAAAAAAAAAAAAAAAAAAAAAA
AAAAAAQAAAAAAAAAAAAAAAAAAAAAAAAAAAAAAFFAAFFFAAAAAAF
AAAAATAAAAAAAAAAAAAAAAAAAAAAAAAAAAAAFAAAAAAAAAAAAGF
AAAAFFFFFAAAAAFFFAAAAAAAAAAAAAAAAAAFFAAAAAAAAAAAAGF
SAAFFFFFFAAAFFFFFAAFAAAFAAAAAFTTAAFFFAFTTFAAAFFFFFA
FFFFFFFFFWWWFFFFFWWFWWFFFFFFFFFFFFFFFFFFFFFFFFFFFFA
FFFFFFFFFWWWFFFFFWWFWWFFFFFFFFFFFFFFFFFFFFFFFFFFFFA