A0A0A0A0A0A0A0A0A0A0A0A0A0A0A0A0A0A0A0A0A0A0A0A0A0A0A0A0A0A0A0A0A0A0A0A0A0A0A0A0A0A0A0A0A0A0A0A0A0A0A0
A0A0A0A0A0A0A0A0A0A0A0A0A0A0A0A0A0A0A0A0A0A0A0A0A0A0A0A0A0A0A0A0A0A0A0A0A0A0A0A0A0A0A0A0A0A0A0A0A0A0A0
A0A0A0A0A0A0A0A0A0A0A0A0A0A0A0A0A0A0A0A0A0A0A0A0A0A0A0A0A0A0A0A0A0A0A0A0A0A0A0A0A0A0A0A0A0A0A0A0A0A0A0
A0A0A0A0A0A0A0A0A0A0A0A0A0A0A0A0A0A0A0A0A0A0A0A0A0A0A0A0A0A0A0A0A0A0A0A0A0A0A0A0A0A0A0A0A0A0A0A0A0A0A0
A0A0A0A0A0A0A0A0A0A0A0A0A0A0A0A0A0A0A0A0A0A0A0A0A0A0A0A0A0A0A0A0A0A0A0A0A0A0A0A0A0A0A0A0A0A0A0A0A0A0A0
A0A0A0A0A0A0A0A0A0A0A0A0A0A0A0A0A0A0A0A0A0A0A0A0A0A0A0A0A0A0A0A0A0A0A0A0A0A0A0A0A0A0A0A0A0A0A0A0A0A0A0
A0A0A0A0A0A0A0A0A0A0A0A0A0A0A0A0A0A0A0A0A0A0A0A0A0A0A0A0A0A0A0A0A0A0A0A0A0A0A0A0A0A0A0A0A0A0A0A0A0A0A0
A0A0A0A0A0A0A0A0A0A0A0A0A0A0A0A0A0A0A0A0A0A0A0A0A0A0A0A0A0A0A0A0A0A0A0A0A0A0A0A0A0A0A0A0A0A0A0A0A0A0A0
A0A0A0A0A0C0A0A0A0A0A0A0A0A0A0A0A0A0A0A0A0A0A0A0A0A0A0A0A0A0A0A0A0A0A0A0A0A0F0F0F0F0F0F0F0A0A0A0A0A0A0
A0A0A0A0C0A0C0Q0A0A0C1A0A0A0C0C0A0A0A0A0A0A0A0A0A0A0A0A0A0A0A0A0A0A0A0A0A0F0t0t0t0t0t0t0t0A0A0A0A0A0F0
A0A0A0A0A0T0A0A0A0A0A0A0A0C0A0A0A0A0A0A0A0A0A0A0A0A0A0A0A0A0A0A0A0A0A0A0F0A0A0A0A0A0A0A0A0A0A0A0A0G0F0
A0A0L0F0F0F0F0F0F0A0A0A0A0A0F0F0F0A0A0A0A0A0A0A0A0A0A0A0A0A0A0A0A0A0A0F0F0A0A0A0A0A0A0A0A0A0A0A0A0G0F0
S0A0L0F0F0F0F0F0F0A0A0A0F0F0F0F0F0A0A0F0A0A0A0F0A0A0A0A0E0F0T0T0A0A0F0F0F0A0A0A0F0T0T0F0T0F0F0F0F0F0A0
F0F0F0F0F0F0F0F0F0W0W0W0F0F0F0F0F0W0W0F0W0W0F0F0F0F0F0F0F0F0F0F0F0F0F0F0F0F0W0F0F0F0F0F0F0F0F0F0F0F0A0
F0F0F0F0F0F0F0F0F0W0W0W0F0F0F0F0F0W0W0F0W0W0F0F0F0F0F0F0F0F0F0F0F0F0F0F0F0F0W0F0F0F0F0F0F0F0F0F0F0F0A0

