AAAAAAAAAAAAAAAAAAAAAAAAAAAAAAAAAAAAAAAAAAAAAAAAAAA
AAAAAAAAAAAAAAAAAAAAAAAAAAAAAAAAAAAAAAAAAAAAAAAAAAA
AAAAAAAAAAAAAAAAAAAAAAAAAAAAAAAAAAAAAAAAAAAAAAAAAAA
AAAAAAAAAAAAAAAAAAAAAAAAAAAAAAAAAAAAAAAAAAAAAAAAAAA
AAAAAAAAAAAAAAAAAAAAAAAAAAAAAAAAAAAAAAAAAAAAAAAAAAA
AAAAAAAAAAAAAAAAAAAAAAAAAAAAAAAAAAAAAAAAAAAAAAAAAAA
AAAAAAAAAAAAAAAAAAAAAAAAAAAAAAAAAAAAAAAAAAAAAAAAAAA
AAAAAAAAAAAAAAAAAAAAAAAAAAAAAAAAAAAAAAAAAAAAAAAAAAA
AAAAAAAAAAAAAAAAAAAAAAAAAAAAAAAAAAAAAAFFFFFFFAAAAAA
AAAAAAQAAAAAAAAAAAAAAAAAAAAAAAAAAAAAAFtttttttAAAAAF
AAAAATAAAAAAAAAAAAAAAAAAAAAAAAAAAAAAFAAAAAAAAAAAAGF
AAAAFFFFFAAAAAFFFAAAAAAAAAAAAAAAAAAFFAAAAAAAAAAAAGF
SAAFFFFFFAAAFFFFFAAFAAAFAAAAEFTTAAFFFAAAFTTFTFFFFFA
FFFFFFFFFWWWFFFFFWWFWWFFFFFFFFFFFFFFFFWFFFFFFFFFFFA
FFFFFFFFFWWWFFFFFWWFWWFFFFFFFFFFFFFFFFWFFFFFFFFFFFA