AAAAAAAAAAAAAAAAAAAAAAAAAAAAAAAAAAG
AAAAAAAAAAAAAAAAAAAAAAAAAAAAAAAAAAG
AAAAAAAAAAAAAAAAAAAAAAAAAAAAAAAAAAG
AAAAAAAAAAAAAAAAAAAAAAAAAAAAAAAAAAG
AAAAAAAAAAAAAAAAAAAAAAAAAAAAAAAAAAG
AAAAAAAAAAAAAAAAAAAAAAAAAAAAAAAAAAG
AAAAAAAAAAAAAAAAAAAAAAAAAAAAAAAAAAG
AAAAAAAAAAAAAAAAAAAAAAAAAAAAAAAAAAG
AAAAAAAAAAAAAAAAAAAAAAAAAAAAAAAAAAG
AAAAAAQAAAAAAAAAAAAAAAAAAAAAAAAAAAG
AAAAAAAAAAAAAAAFAAAAAAAAAAAAAAAAAAG
AAAAFFFFFAAAAAFFFAAAAAAAAAAAAAAAAAG
SAAFFFFFFAAFFFFFFAFAFAAFAAAAEAAAAFG
FFFFFFFFFWWFFFFFFWFWFWFFFFFFFFFFFFG
FFFFFFFFFWWFFFFFFWFWFWFFFFFFFFFFFFG