AAAAAAAAAAAAAAAAAAAAAAAAAAAAAAAAAAAAAAAAAAAAAAAAAAA
AAAAAAAAAAAAAAAAAAAAAAAAAAAAAAAAAAAAAAAAAAAAAAAAAAA
AAAAAAAAAAAAAAAAAAAAAAAAAAAAAAAAAAAAAAAAAAAAAAAAAAA
AAAAAAAAAAAAAAAAAAAAAAAAAAAAAAAAAAAAAAAAAAAAAAAAAAA
AAAAAAAAAAAAAAAAAAAAAAAAAAAAAAAAAAAAAAAAAAAAAAAAAAA
AAAAAAAAAAAAAAAAAAAAAAAAAAAAAAAAAAAAAAAAAAAAAAAAAAA
AAAAAAAAAAAAAAAAAAAAAAAAAAAAAAAAAAAAAAAAAAAAAAAAAAA
AAAAAAAAAAAAAAAAAAAAAAAAAAAAAAAAAAAAAAAAAAAAAAAAAAA
AAAAAAAAAAAAAAAAAAAAAAAAAAAAAAAAAAAAAAFFFFFFFAAAAAA
AAAAAAQAAAAAAAAAAAAAAAAAAAAAAAAAAAAAAFAAAAAAAAAAAAF
AAAAATAAAAAAAAAAAAAAAAAAAAAAAAAAAAAAFAAAAAAAAAAAAGF
AAAAFFFFFAAAAAFFFAAAAAAAAAAAAAAAAAAFFAAAAAAAAAAAAGF
SAAFFFFFFAAAFFFFFAAFAAAFAAAAAFTTAAFFFAAAFTTFAFFFFFA
FFFFFFFFFWWWFFFFFWWFWWFFFFFFFFFFFFFFFFWFFFFFFFFFFFA
FFFFFFFFFWWWFFFFFWWFWWFFFFFFFFFFFFFFFFWFFFFFFFFFFFA