AAAAAAAAAAAAAAAAAAAAAAAAAAAAAAAAAAG
AAAAAAAAAAAAAAAAAAAAAAAAAAAAAAAAAAG
AAAAAAAAAAAAAAAAAAAAAAAAAAAAAAAAAAG
AAAAAAAAAAAAAAAAAAAAAAAAAAAAAAAAAAG
AAAAAAAAAAAAAAAAAAAAAAAAAAAAAAAAAAG
AAAAAAAAAAAAAAAAAAAAAAAAAAAAAAAAAAG
AAAAAAAAAAAAAAAAAAAAAAAAAAAAAAAAAAG
AAAAAAAAAAAAAAAAAAAAAAAAAAAAAAAAAAG
AAAAAAAAAAAAAAAAAAAAAAAAAAAAAAAAAAG
AAAAAAQAAAAAAAAAAAAAAAAAAAAAAAAAAAG
AAAAATAAAAAAAAAAAAAAAAAAAAAAAAAAAAG
AAAAFFFFFAAAAAFFFAAAAAAAAAAAAAAAAAG
SAAFFFFFFAAAFFFFFAAFAAAFAAAAAFTTAFG
FFFFFFFFFWWWFFFFFWWFWWFFFFFFFFFFFFG
FFFFFFFFFWWWFFFFFWWFWWFFFFFFFFFFFFG