AAAAAAAAAAAAAAAAAAAAAAAAAAAAAAAAAAAAAAAAAAAAAAAAAAA
AAAAAAAAAAAAAAAAAAAAAAAAAAAAAAAAAAAAAAAAAAAAAAAAAAA
AAAAAAAAAAAAAAAAAAAAAAAAAAAAAAAAAAAAAAAAAAAAAAAAAAA
AAAAAAAAAAAAAAAAAAAAAAAAAAAAAAAAAAAAAAAAAAAAAAAAAAA
AAAAAAAAAAAAAAAAAAAAAAAAAAAAAAAAAAAAAAAAAAAAAAAAAAA
AAAAAAAAAAAAAAAAAAAAAAAAAAAAAAAAAAAAAAAAAAAAAAAAAAA
AAAAAAAAAAAAAAAAAAAAAAAAAAAAAAAAAAAAAAAAAAAAAAAAAAA
AAAAAAAAAAAAAAAAAAAAAAAAAAAAAAAAAAAAAAAAAAAAAAAAAAA
AAAAAAAAAAAAAAAAAAAAAAAAAAAAAAAAAAAAAAFFFFFFFAAAAAA
AAAAAAAQAAAAAAAAAAAAAAAAAAAAAAAAAAAAAFtttttttAAAAAF
AAAAATAAAAAAAAAAAAAAAAAAAAAAAAAAAAAAFAAAAAAAAAAAAGF
AALFFFFFFAAAAAFFFAAAAAAAAAAAAAAAAAAFFAAAAAAAAAAAAGF
SALFFFFFFAAAFFFFFAAFAAAFAAAAEFTTAAFFFAAAFTTFTFFFFFA
FFFFFFFFFWWWFFFFFWWFWWFFFFFFFFFFFFFFFFWFFFFFFFFFFFA
FFFFFFFFFWWWFFFFFWWFWWFFFFFFFFFFFFFFFFWFFFFFFFFFFFA