AAAAAAAAAAAAAAAAAAAAAAAAAAAAAAAAAAAAAAAAAAAAAAAAAAA
AAAAAAAAAAAAAAAAAAAAAAAAAAAAAAAAAAAAAAAAAAAAAAAAAAA
AAAAAAAAAAAAAAAAAAAAAAAAAAAAAAAAAAAAAAAAAAAAAAAAAAA
AAAAAAAAAAAAAAAAAAAAAAAAAAAAAAAAAAAAAAAAAAAAAAAAAAA
AAAAAAAAAAAAAAAAAAAAAAAAAAAAAAAAAAAAAAAAAAAAAAAAAAA
AAAAAAAAAAAAAAAAAAAAAAAAAAAAAAAAAAAAAAAAAAAAAAAAAAA
AAAAAAAAAAAAAAAAAAAAAAAAAAAAAAAAAAAAAAAAAAAAAAAAAAA
AAAAAAAAAAAAAAAAAAAAAAAAAAAAAAAAAAAAAAAAAASAAAAAAAA
AAAAAAAAAAAAAAAAAAAAAAAAAAAAAAAAAAAAAAFFFFFFFAAAAAA
AAAAAAQAAAAAAAAAAAAAAAAAAAAAAAAAAAAAAFttAAtAtAFAAAF
AAAAATAAAAAAAAAAAAAAAAAAAAAAAAAAAAAAFtAAAAAAAAAAFGF
AAAAFFFFFAAAAAFFFAAAAAAAAAAAAAAAAAAFFAAAAAAAAAFAAGF
AAAFFFFFFAAAFFFFFAAFAAAFAAAAEFTTAAFFFAAAFTTFTFFFFFA
FFFFFFFFFWWWFFFFFWWFWWFFFFFFFFFFFFFFFFWFFFFFFFFFFFA
FFFFFFFFFWWWFFFFFWWFWWFFFFFFFFFFFFFFFFWFFFFFFFFFFFA